00020003040500000100030100010200010302030000000100000000343433340000000000000000
10111112001501101112020201000100010000000300000100000000010100330000000000000000
20212122342500202122010000000301000201010200000100000000000000330000000000000103
30313132003500202122000110111112010000101112000000000000000001330000000000000033
40414243444501202122010320212122000001202122000200000000000000340000000000000033
00030101000103303132010030313132000000303132000000000000000000340000000000000133
00010000000100010101010000000000101200010102000000000000000001330000000000000033
01000100000101020000101200010034202233000001340000000000000002330000000000000034
00001011111112011012303234010301303202010002000000000000000003340000000000000234
02012021211332022022010310111200010200000001000003000000000000340000000000000233
01003031313201033032000030313200101112010001101200000000010001340000000000000334
00000000000101010034000134010001202122020001303201000033343434340000000000000034
00000000000000000000000000010000000000000000010200000000000000000000000000000034
00000000000000000001010010120200000000000000000000000000000000000000000000000234
00000000000000000000330030320000000002000000000000000200000000000000000000000034
00000000000000000000340300000000000033000000000000023301000000000000000000000134
00000000000000000000340000000000000034000000000000020102000000000000000000000134
00000000000000000000340100000000000033000000000000000000000000000000000000000234
00000000000000000001330000000003000234000000000000000002000001000102000201010034
00000000000000000003333334333434343434000000000000000003333334343333333334333433

image image:bgtiles
