00020003040500000100030100010200010302030000000100000000343433340000000000000000
10111112001501101112020201000100010000000300000100000000010100330000000000000000
20212122340201202122011011111201000201010200000100000000000000330000000000000103
30313132020000202122002021212200010000101112000000000000000001330000000000000033
40414243440000303132013031313200000001202122000200000000000000340000000000000033
00030101030200000133000200000000000000303132000000000000000000340000000000000133
00010000000300030200000001000000101200010102000000000000000001330000000000000033
01000100000101020000330100000034202233000001340000000000000002330000000000000034
00001011111112011012333401030000303202010002000000000000000003340000000000000234
02012021211332022022010010120201010101010001000003000000000000340000000000000233
01003031313201033032000030323402010001000001101200000000010001340000000000000334
02020000000101010034000134010000333400000002303201000033343434340000000000000034
02020000000000000000000000010000000000000000010200000000000000000000000000000034
00020100000000000001010010120200000002010001000000000000000000000000000000000234
00000000000000000000330030320000000002000000000000000200000000000000000000000034
00000000000000000000340300000000000033000000000000023301000000000000000000000134
00000000000000000000340000000000000034000000000000020102000000000000000000000134
00000000000000000000340100000000000033000000000000000000000000000000000000000234
00000000000000000001330000000003000234000000000000000002000001000102000201010034
00000000000000000003333334333434343434000000000000000003333334343333333334333433

image image:bgtiles
0x40 @10,2,5,3
door @2,2 map:1 @0,0 *
sprite @2,5 sprite:1 *
sprite @1,1 (u16)0 *
sprite @10,2 sprite:1 *
sprite @6,5 sprite:1 *
door @11,18 map:1 @3,0 *
