1011123410111200340201331011111111123334
2021220030313234333300023014211331320034
2021231112000033013333010130313201000233
3031141332010010111200021012003334000134
3300303200033430311012343032000033343434
3300330201333403002022000133000000030334
1011111201340234023010111112343433331012
2021212201013433340130313132000000002022
2021212200010001330033000100020001102422
3031313234010100340034023334343434303132

image image:bgtiles
